6 6 6 6 6 6 6 6 6 6
6 5 0 5 0 0 5 0 5 6
6 0 4 0 4 4 0 4 0 6
6 5 0 3 0 0 3 0 5 6
6 0 4 0 1 1 0 4 0 6
6 5 0 2 0 0 2 0 5 6
6 0 5 0 5 5 0 5 0 6
6 6 6 6 6 6 6 6 6 6