0 0 0 0 0 0 0 0 0 0
0 5 5 5 5 5 5 5 5 0
0 5 4 4 4 4 4 4 5 0
0 5 4 3 3 3 3 4 5 0
0 5 4 3 2 2 3 4 5 0
0 5 4 3 3 3 3 4 5 0
0 5 4 4 4 4 4 4 5 0
0 5 5 5 5 5 5 5 5 0